alignas
alignof
and
and_eq
asm — Ключевое слово для вставки одной или нескольких инструкций ассемблера
auto — Спецификатор типа для указания компилятору локальной области видимости переменной(по умолчанию)
bitand
bitor
bool — Логический тип данных (версия C++)
break — Оператор выхода из цикла
case — Оператор указания варианта выбора(используется вместе с switch)
catch — Блок программы которая содержит ту часть программы, которая обрабатывает ошибку
char — Символьный тип данных
char16_t
char32_t
class — Пользовательский тип данных "класс"
compl
concept
const — Объекты типа const не могут быть изменены программой во время её выполнения
const_cast<T>(x) — Непроверяемое преобразование, которое сводится к добавлению или удалению модификатора const у типа объекта x, что бы получить объект типа Т
constexpr
continue — Оператор продолжения цикла с пропуском оставшихся операторов до конца блока
decltype
default — Оператор выбора по умолчанию
delete — Оператор освобождает память на которую указывает аргумент
do — Оператор цикла с постусловием без счётчика
double — Тип данных с плавающей запятой двойной точности
dynamic_cast<T>(x) — Оператор привидения типа, проверяет законность выполнения заданной операции приведения типа (преобразование времени выполнения объекта x в T с проверкой)
else — Условный оператор "в противном случае"
enum — Пользовательский тип данных "перечисляемый тип"
explicit — Конструктор, определённый с помощью спецификатора expliclt, будет использоваться только в том случае, если инициализация в точности совпадает с тем, что задано конструктором
export — Ключевое слово, позволяющее другим файлам использовать шаблон, объявленный в другом файле путём задания лишь его объявления.
extern — Спецификатор типа для указания компилятору внешней привязки переменной
false — Логическая константа, имеющую значение "ложь".
float — Тип данных с плавающей запятой
for — Оператор цикла с предусловием, с счётчиком
friend — Ключевое слово определяет дружественные функции или классы
goto — Оператор безусловного перехода
if — Условный оператор "если"
inline — Спецификатор используемый для помещения тела функции непосредственно в текст программы
int — Целочисленный тип данных
long — Модификатор типа данных для определения длинных переменных
mutable — Спецификатор типа позволяет члену некоторого объекта переопределить свойство постоянства
namespace — Ключевое слово для создания пространства имён
new — Оператор выделяет динамическую память и возвращает указатель соответствующего типа на эту область памяти
noexcept
not
not_eq
nullptr
operator — Ключевое слово operator используется для создания перегруженных функций-операторов
or
or_eq
private — Спецификатор доступа "приватный", определяющий способ наследования базового класса
protected — Спецификатор доступа "защищённый", определяющий способ наследования базового класса
public — Спецификатор доступа "открытый", определяющий способ наследования базового класса
register — Спецификатор типа для хранения переменной в регистрах процессора
reinterpret_cast<T>(x) — Непроверяемое преобразование объекта x в объект типа Т путём иной интерпритации битовой комбинации объекта х
requires
return — Оператор для возврата из функции значения
short — Модификатор типа данных для определения коротких переменных(обычно не используется)
signed — Модификатор типа данных для определения знаковых переменных
sizeof — Оператор служащий для определения размера типа данных во время компиляции
static — Указывает компилятору хранить локальную переменную во время всего жизненного цикла программы
static_assert
static_cast<T>(x) — Оператор привидения типа, выполняет не полиморфное приведение типов (преобразование времени компиляции объекта x в T c проверкой)
struct — Пользовательский тип данных "структура"
switch — Оператор выбора
template — Ключевое слово template используется для создания обобщённых функций и классов
this — Используется для обозначения указателей на объект, который сгенерировал обращение к функции-члену
thread_local
throw — Оператор throw генерирует исключение
true — Логическая константа, имеющую значение "истина"
try — Блок программы которая содержит ту часть программы, которая предназначена для обработки ошибок
typedef — Оператор для создания нового имени типа данных
typeid — Оператор typeid возвращает ссылку на объект type_info, описывающий тип объекта, к которому принадлежит оператор typeid
typename — Ключевое слово, которое можно использовать вместо ключевого слова class в объявлении template или для обозначения неопределённого типа
union — Пользовательский тип данных "объединение"
unsigned — Модификатор типа данных для определения беззнаковых переменных
using — Переносит переменную из определённого пространства имён в глобальную область видимости переменных
virtual — Спецификатор типа определяющий виртуальные функции
void — Пустой тип данных
volatile — Квалификатор типа сообщает компилятору, что значение переменной может быть изменено средствами, заданными в программе неявным образом
wchar_t — Символьный двухбайтовый тип данных
while — Оператор цикла с предусловием, без счётчика
xor
xor_eq